NO textures/simonkraft/wet_sponge.xpm
SO textures/simonkraft/wet_sponge.xpm
WE textures/simonkraft/wet_sponge.xpm
EA textures/simonkraft/wet_sponge.xpm

F 164,169,20
C 153,204,255

        1111111111111111111111111
        1000000000110000000000001
        101100000111000N000000001
        1001000000000111000000001
111111111011000001110000111110001
100000000011000001110111111111111
11110111111111011100000010001
11110111111111011101010010001
11000000110101011000000010001
10000000000000001100000010001
10000000000000001101010010001
1100000111010101111101111000111
11110111 1110101 101111010001
11111111 1111111 111111111111