NO textures/simonkraft/wet_sponge.xpm
SO textures/simonkraft/wet_sponge.xpm
WE textures/simonkraft/wet_sponge.xpm
EA textures/simonkraft/wet_sponge.xpm

F 164,169,20
C 153,204,255

1111111111111111111111111
1000000000110000000000001
10110000011100000000W0001
1001000000000111000000001
1111111110110000011100001
1000000000110000011101111
1111011111111101110000001
1111011111111101110101001
1100000011010101100000001
1000000000000000110000001
1000000000000000110101001
1100000111010101111101111
1111011111101011011110101
1111111111111111111111111