NO textures/planks.xpm
SO textures/planks.xpm
WE textures/planks.xpm
EA textures/planks.xpm

F 34,139,34
C 135,206,235

11111111111111111111111
10000000010000000000001
10111111110111111111001
10000000000000000000001
10111011111011110111001
10000000000000000000001
1000000000S000000000001
10000000000000000000001
10111111110111111111001
10000000000000000000001
11111111111111111111111
