NO textures/n.xpm
SO textures/s.xpm
WE textures/w.xpm
EA textures/e.xpm

        F 0,255,0
C 135,206,235

11111111111111111111111
10000000010000000000001
10000000000000000000001
10000000001000000100001
10000000000000000010001
10000000001000000000001
10000000000000000100001
10000E00000001001000001
10000001000001000000001
10000000000001000000001
11111111111111111111111