







NO ./textures/north.xpm








SO ./textures/south.xpm
                        WE ./textures/west.xpm
        EA ./textures/east.xpm            

        F 20,           20,             20
C 200,          200,200

11111
10001
10001                
10001
10001
100011
11E001               
100011
10001
10001
10001
10001
11111           

        





















